"filename", "language", "Python", "Shell Script", "Markdown", "comment", "blank", "total"
"/home/ZIYIAP/Documents/OneDrive_local/code/distiller/CRD_RepDistiller/README.md", "Markdown", 0, 0, 99, 0, 30, 129
"/home/ZIYIAP/Documents/OneDrive_local/code/distiller/CRD_RepDistiller/crd/__init__.py", "Python", 0, 0, 0, 0, 1, 1
"/home/ZIYIAP/Documents/OneDrive_local/code/distiller/CRD_RepDistiller/crd/criterion.py", "Python", 79, 0, 0, 3, 21, 103
"/home/ZIYIAP/Documents/OneDrive_local/code/distiller/CRD_RepDistiller/crd/memory.py", "Python", 104, 0, 0, 12, 23, 139
"/home/ZIYIAP/Documents/OneDrive_local/code/distiller/CRD_RepDistiller/dataset/cifar100.py", "Python", 175, 0, 0, 4, 35, 214
"/home/ZIYIAP/Documents/OneDrive_local/code/distiller/CRD_RepDistiller/dataset/imagenet.py", "Python", 187, 0, 0, 2, 42, 231
"/home/ZIYIAP/Documents/OneDrive_local/code/distiller/CRD_RepDistiller/distiller_zoo/AB.py", "Python", 22, 0, 0, 2, 6, 30
"/home/ZIYIAP/Documents/OneDrive_local/code/distiller/CRD_RepDistiller/distiller_zoo/AT.py", "Python", 23, 0, 0, 0, 7, 30
"/home/ZIYIAP/Documents/OneDrive_local/code/distiller/CRD_RepDistiller/distiller_zoo/CC.py", "Python", 13, 0, 0, 23, 7, 43
"/home/ZIYIAP/Documents/OneDrive_local/code/distiller/CRD_RepDistiller/distiller_zoo/FSP.py", "Python", 41, 0, 0, 0, 8, 49
"/home/ZIYIAP/Documents/OneDrive_local/code/distiller/CRD_RepDistiller/distiller_zoo/FT.py", "Python", 25, 0, 0, 0, 7, 32
"/home/ZIYIAP/Documents/OneDrive_local/code/distiller/CRD_RepDistiller/distiller_zoo/FitNet.py", "Python", 10, 0, 0, 0, 5, 15
"/home/ZIYIAP/Documents/OneDrive_local/code/distiller/CRD_RepDistiller/distiller_zoo/KD.py", "Python", 13, 0, 0, 0, 5, 18
"/home/ZIYIAP/Documents/OneDrive_local/code/distiller/CRD_RepDistiller/distiller_zoo/KDSVD.py", "Python", 59, 0, 0, 0, 17, 76
"/home/ZIYIAP/Documents/OneDrive_local/code/distiller/CRD_RepDistiller/distiller_zoo/NST.py", "Python", 33, 0, 0, 1, 8, 42
"/home/ZIYIAP/Documents/OneDrive_local/code/distiller/CRD_RepDistiller/distiller_zoo/PKT.py", "Python", 26, 0, 0, 5, 12, 43
"/home/ZIYIAP/Documents/OneDrive_local/code/distiller/CRD_RepDistiller/distiller_zoo/RKD.py", "Python", 41, 0, 0, 2, 16, 59
"/home/ZIYIAP/Documents/OneDrive_local/code/distiller/CRD_RepDistiller/distiller_zoo/SP.py", "Python", 21, 0, 0, 2, 8, 31
"/home/ZIYIAP/Documents/OneDrive_local/code/distiller/CRD_RepDistiller/distiller_zoo/VID.py", "Python", 47, 0, 0, 1, 7, 55
"/home/ZIYIAP/Documents/OneDrive_local/code/distiller/CRD_RepDistiller/distiller_zoo/__init__.py", "Python", 13, 0, 0, 0, 1, 14
"/home/ZIYIAP/Documents/OneDrive_local/code/distiller/CRD_RepDistiller/helper/__init__.py", "Python", 0, 0, 0, 0, 1, 1
"/home/ZIYIAP/Documents/OneDrive_local/code/distiller/CRD_RepDistiller/helper/loops.py", "Python", 200, 0, 0, 19, 45, 264
"/home/ZIYIAP/Documents/OneDrive_local/code/distiller/CRD_RepDistiller/helper/pretrain.py", "Python", 78, 0, 0, 3, 14, 95
"/home/ZIYIAP/Documents/OneDrive_local/code/distiller/CRD_RepDistiller/helper/util.py", "Python", 46, 0, 0, 0, 17, 63
"/home/ZIYIAP/Documents/OneDrive_local/code/distiller/CRD_RepDistiller/models/ShuffleNetv1.py", "Python", 116, 0, 0, 1, 22, 139
"/home/ZIYIAP/Documents/OneDrive_local/code/distiller/CRD_RepDistiller/models/ShuffleNetv2.py", "Python", 172, 0, 0, 9, 30, 211
"/home/ZIYIAP/Documents/OneDrive_local/code/distiller/CRD_RepDistiller/models/__init__.py", "Python", 31, 0, 0, 0, 2, 33
"/home/ZIYIAP/Documents/OneDrive_local/code/distiller/CRD_RepDistiller/models/classifier.py", "Python", 20, 0, 0, 3, 13, 36
"/home/ZIYIAP/Documents/OneDrive_local/code/distiller/CRD_RepDistiller/models/mobilenetv2.py", "Python", 152, 0, 0, 9, 42, 203
"/home/ZIYIAP/Documents/OneDrive_local/code/distiller/CRD_RepDistiller/models/resnet.py", "Python", 195, 0, 0, 1, 61, 257
"/home/ZIYIAP/Documents/OneDrive_local/code/distiller/CRD_RepDistiller/models/resnetv2.py", "Python", 161, 0, 0, 3, 35, 199
"/home/ZIYIAP/Documents/OneDrive_local/code/distiller/CRD_RepDistiller/models/util.py", "Python", 240, 0, 0, 0, 51, 291
"/home/ZIYIAP/Documents/OneDrive_local/code/distiller/CRD_RepDistiller/models/vgg.py", "Python", 193, 0, 0, 1, 43, 237
"/home/ZIYIAP/Documents/OneDrive_local/code/distiller/CRD_RepDistiller/models/wrn.py", "Python", 134, 0, 0, 5, 32, 171
"/home/ZIYIAP/Documents/OneDrive_local/code/distiller/CRD_RepDistiller/scripts/fetch_pretrained_teachers.sh", "Shell Script", 0, 21, 0, 1, 9, 31
"/home/ZIYIAP/Documents/OneDrive_local/code/distiller/CRD_RepDistiller/scripts/run_cifar_distill.sh", "Shell Script", 0, 14, 0, 16, 2, 32
"/home/ZIYIAP/Documents/OneDrive_local/code/distiller/CRD_RepDistiller/scripts/run_cifar_vanilla.sh", "Shell Script", 0, 6, 0, 1, 7, 14
"/home/ZIYIAP/Documents/OneDrive_local/code/distiller/CRD_RepDistiller/train_student.py", "Python", 258, 0, 0, 28, 62, 348
"/home/ZIYIAP/Documents/OneDrive_local/code/distiller/CRD_RepDistiller/train_teacher.py", "Python", 120, 0, 0, 14, 43, 177
"Total", "-", 3048, 41, 99, 171, 797, 4156